11111111111111111111
100000000000C0000001
100000000C00000000E1
1P0000000000000C0001
11111111111111111111
