11111111111111111111111111111111111111111111111111
10E01000000000010000000001000000000000000000000001
10001001100010010001110001000000000000000000000001
10001001010010010010001001000000011111111111111111
10001001001010010010001001000000000000000000000001
10001001000110010010001001000000000000000000000001
10001001000010010001110001000000010000000000000001
10001000000000010000000001000000010000000000000001
10001000000000010000000001000000010000000000000001
10000000000000000000000000000000010000000000000001
10000000000000000000000000000000010000000000000001
11111111111111110000001111111111111111111111111111
10000000000000000000000000000000000000000000000001
1P000000000000000000000000000000000000000000000001
11111111111111111111111111111111111111111111111111
